#,#, ,#,#,#,#,#,#,#,#,#,#,#,#,#,#,#,#,#,#,#,#,#,#,#,#,#,#,#,#,#,#,#,#,#,#,#,#,#,#
#, , , , , , , ,#, , , , , , , , , , , , , , , ,#, , , ,#, , , , , ,#, , , , , ,#
#, ,#,#,#, ,#,#,#,#,#,#,#,#,#, ,#, ,#,#,#,#,#, ,#, ,#,#,#, ,#,#,#, ,#, ,#,#,#,#,#
#, ,#, , , ,#, , , , , , , ,#, ,#, ,#, , , , , , , ,#, , , ,#, , , ,#, ,#, , , ,#
#, ,#, ,#, ,#, ,#,#,#,#,#, ,#, ,#, ,#,#,#,#,#,#,#,#,#, ,#,#,#,#,#, ,#, ,#, ,#, ,#
#, ,#, ,#, ,#, , , , , ,#, ,#, ,#, , , , , , , , , ,#, , , , , ,#, , , , , ,#, ,#
#,#,#, ,#, ,#,#,#,#,#,#,#, ,#,#,#,#,#,#, , ,#,#,#, ,#, ,#, ,#, ,#,#,#,#,#,#,#, ,#
#, , , ,#, , , , , , , ,#, , , , , , , , , ,#, , , ,#, ,#, ,#, , , ,#, , , , , ,#
#, ,#,#,#, ,#,#,#,#,#, ,#,#,#,#,#, ,#,#,#,#,#, ,#,#,#, ,#, ,#,#,#, ,#, ,#,#,#,#,#
#, ,#, ,#, , , , , ,#, , , , , ,#, , , ,#, , , ,#, , , ,#, ,#, , , ,#, ,#, , , ,#
#, ,#, ,#, ,#,#,#, ,#,#,#,#,#, ,#, ,#,#,#, ,#,#,#,#,#,#,#, ,#, ,#,#,#, ,#,#,#, ,#
#, ,#, ,#, ,#, ,#, , , , , ,#, ,#, ,#, , , ,#, , , , , , , ,#, ,#, , , , , ,#, ,#
#, ,#, ,#, ,#, ,#,#,#,#,#, ,#, ,#,#,#, ,#,#,#,#,#, ,#,#,#,#,#, ,#,#,#,#,#, ,#, ,#
#, , , ,#, , , , , , , ,#, ,#, , , , , , , , , ,#, ,#, , , , , , , , , ,#, ,#, ,#
#,#,#, ,#,#,#,#,#,#,#, ,#, ,#,#,#,#,#,#,#,#,#, ,#, ,#,#,#,#,#,#,#, ,#,#,#, ,#, ,#
#, ,#, , , , , ,#, ,#, ,#, ,#, , , , , , , ,#, ,#, , , , , , , ,#, , , ,#, , , ,#
#, ,#,#,#,#,#,#,#, ,#, ,#, ,#, ,#,#,#,#,#, ,#, ,#,#,#,#,#,#,#,#,#,#,#, ,#, ,#, ,#
#, , , , , , , , , ,#, ,#, ,#, ,#, , , ,#, , , ,#, , , , , , , , , ,#, ,#, ,#, , 
#,#,#,#,#, ,#, ,#,#,#, ,#, ,#,#,#, ,#, ,#,#,#,#,#, ,#, ,#, ,#, ,#,#,#, ,#, ,#,#,#
#, ,#, , , ,#, , , , , ,#, , , , , ,#, , , , , , , ,#, ,#, ,#, ,#, , , ,#, , , ,#
#, ,#, ,#, ,#, ,#,#,#, ,#, ,#,#,#, ,#, ,#,#,#,#,#,#,#, ,#, ,#, ,#, ,#,#,#,#,#, ,#
#, ,#, ,#, ,#, ,#, , , ,#, ,#, , , , , ,#, , , , , ,#, ,#, ,#, , , ,#, , , ,#, ,#
#, ,#, ,#, ,#, ,#,#,#,#,#, ,#,#,#, ,#,#,#,#,#,#,#, ,#, ,#, ,#,#,#,#,#, ,#,#,#, ,#
#, ,#, ,#, ,#, ,#, , , , , , , ,#, , , , , ,#, ,#, ,#, , , , , , , ,#, , , , , ,#
#, ,#, ,#,#,#, ,#,#,#,#,#,#,#, ,#, ,#,#,#, ,#, ,#, ,#,#,#, ,#,#,#,#,#, ,#, ,#,#,#
#, , , ,#, ,#, , , , , ,#, , , ,#, , , ,#, , , , , , , ,#, ,#, , , , , ,#, , , ,#
#,#,#, ,#, ,#,#,#,#,#, ,#, ,#,#,#, ,#,#, , ,#,#,#,#,#,#,#, ,#, ,#,#,#,#,#,#,#, ,#
#, , , , , , , ,#, ,#, ,#, ,#, , , ,#, ,#, , , ,#, , , , , ,#, ,#, , , , , , , ,#
#, ,#,#,#,#,#, ,#, ,#, ,#, ,#, ,#, ,#, ,#,#,#, ,#,#,#, ,#,#,#, ,#,#,#,#,#,#,#, ,#
#, ,#, , , ,#, ,#, , , , , , , , , ,#, ,#, ,#, , , , , ,#, ,#, , , , , , , ,#, ,#
#, ,#, ,#,#,#, ,#, ,#, ,#, ,#, ,#,#,#, ,#, ,#,#,#,#,#,#,#, ,#,#,#,#,#, ,#, ,#, ,#
#, ,#, , , , , ,#, ,#, ,#, ,#, , , ,#, ,#, , , , , , , ,#, , , , , ,#, ,#, ,#, ,#
#, ,#,#,#,#,#, ,#, ,#, ,#,#,#,#,#, ,#, ,#, ,#,#, ,#,#, ,#,#,#, ,#,#,#, ,#, ,#, ,#
#, , , , , ,#, , , ,#, , , , , ,#, , , ,#, ,#, , , ,#, , , , , ,#, , , ,#, ,#, ,#
#, ,#,#,#, ,#,#,#,#,#, ,#,#,#, ,#,#,#, ,#, ,#, ,#,#,#, ,#,#,#,#,#, ,#,#,#, ,#, ,#
#, ,#, ,#, , , , , ,#, ,#, ,#, , , ,#, , , ,#, , , , , ,#, , , , , ,#, ,#, ,#, ,#
#, ,#, ,#,#,#,#,#, ,#, ,#, ,#,#,#, ,#,#,#, ,#,#,#,#,#,#,#, ,#,#,#,#,#, ,#, ,#, ,#
#, ,#, , , , , ,#, , , ,#, ,#, , , , , ,#, ,#, , , , , , , ,#, , , ,#, , , ,#, ,#
#, ,#, ,#,#,#, ,#,#,#,#,#, ,#, ,#,#,#, , , ,#, ,#,#,#,#,#,#,#, ,#, ,#,#,#,#,#, ,#
 , , , ,#, , , , , , , , , ,#, , , ,#, , , ,#, , , , , , , , , ,#, , , , , , , ,#
 , ,#,#,#,#,#,#,#,#,#,#,#,#,#,#,#,#,#,#,#,#,#,#,#,#,#,#,#,#,#, ,#,#,#,#,#,#,#,#,#