#,#,#,#,#,#,#,#,#,#,#,#,#,#,#,#,#,#,#,#,#,#
#, , , , ,#, , , , , ,#, , , , , , , , , ,#
#, ,#,#, ,#, ,#, ,#, ,#,#,#, ,#,#,#,#,#, ,#
#, ,#, , ,#, ,#, ,#, , , , , ,#,#,#,#,#,#,#
#, ,#, ,#,#, ,#, ,#, ,#,#,#,#,#,#, , , , , 
#, ,#, ,#, , ,#, ,#, ,#,#,#,#, ,#, ,#,#,#,#
#,#,#, ,#, ,#,#, ,#, ,#, ,#,#, ,#, ,#,#,#,#
#, , , ,#, ,#,#, ,#, ,#, ,#,#, ,#, ,#, , ,#
#, ,#,#,#, ,#,#,#,#, ,#, ,#,#, ,#, ,#, ,#,#
#, ,#, ,#, ,#, , , , ,#, ,#,#, ,#, ,#, ,#,#
#, ,#, , , ,#, ,#,#,#,#, , , , ,#, ,#, ,#,#
#, ,#,#,#, , , ,#, ,#,#, ,#,#,#,#, ,#, ,#,#
#, , , ,#, ,#, ,#, ,#,#, ,#,#,#,#, ,#, ,#,#
#,#,#, , , ,#, ,#, ,#,#, , , , ,#, ,#, ,#,#
#, ,#, ,#,#,#, ,#, ,#,#,#,#,#, ,#, , , , ,#
#, ,#, ,#, , , ,#, , , , , , , ,#, ,#,#, ,#
#, ,#, ,#, ,#,#,#, ,#,#,#,#,#,#,#, ,#,#, ,#
#, ,#, ,#, ,#, , , ,#,#, , , , , , , ,#, ,#
#, ,#, ,#, ,#,#,#, ,#,#, ,#,#, ,#,#,#,#, ,#
#, , , ,#, , , ,#, ,#,#, ,#,#, ,#, ,#,#, ,#
#,#, ,#,#,#,#, ,#, ,#,#, ,#,#, , , , ,#, ,#
#, , , , , ,#, , , , ,#, ,#,#, ,#,#, ,#, ,#
#, ,#,#,#, ,#, ,#,#, , , ,#, , , ,#, ,#, ,#
#, ,#, , , ,#, , ,#,#,#,#,#,#,#, ,#,#,#, ,#
#, ,#,#,#,#,#, ,#,#, , , , , ,#, , ,#,#, ,#
#, , , , , ,#,#,#,#, ,#,#,#, ,#,#, ,#,#, ,#
#, ,#,#,#, , , , ,#, ,#, ,#, , ,#, , , , ,#
#, ,#, ,#,#,#,#, ,#, ,#, ,#,#, ,#,#,#, ,#,#
#, ,#, , , , ,#, , , ,#, ,#, , , , ,#, ,#,#
#, ,#, ,#,#, ,#,#,#,#,#, ,#, ,#,#, ,#, ,#,#
 , , , ,#, , , , , , , , ,#, , ,#, , , ,#,#
#,#,#,#,#,#,#,#,#,#,#,#,#,#,#,#,#,#,#,#,#,#