#,#,#,#,#,#,#,#,#,#,#,#,#,#,#,#,#,#,#,#,#,#,#,#,#,#,#,#,#,#,#,#,#,#,#,#,#,#,#,#,#,#,#,#,#,#,#,#,#,#,#,#,#,#,#,#,#,#,#,#,#,#,#,#,#,#
#,#,#,#,#,#,#,#,#,#,#,#,#,#,#,#,#,#,#,#,#,#,#,#,#,#,#,#,#,#,#,#,#,#,#,#,#,#,#,#,#,#,#,#,#,#,#,#,#,#,#,#,#,#,#,#,#,#,#,#,#,#,#,#,#,#
#,#, , , ,#, , , , , ,#,#, , , , , , , , , , , , ,#, , , , , , , , , , , , , , , , , , , , , , , , , , , ,#, , , , , , , , , , ,#,#
#,#,#,#, ,#, ,#, ,#, ,#,#, ,#,#,#, ,#,#,#,#,#,#,#,#, ,#,#,#,#,#,#,#,#,#,#, ,#,#,#,#,#,#,#,#,#,#,#,#,#,#, ,#,#,#,#,#,#,#,#, ,#, ,#,#
#,#, , , ,#, ,#, ,#, ,#,#, , , ,#, , , ,#, , , , , , ,#, , , , , , , , ,#, ,#, , , , , , , , , , , , , , , , , , , , , , , ,#, ,#,#
#,#, ,#,#,#,#,#, ,#, ,#,#,#,#, ,#,#,#, ,#, ,#,#,#,#,#,#,#,#, ,#, ,#,#,#,#, ,#, ,#,#,#,#,#,#,#,#,#,#,#,#,#,#,#,#,#, ,#,#,#,#,#,#,#,#
#,#, , , , , , , ,#, ,#,#, ,#, , , ,#, , , , , , , , , , , , ,#, ,#,#, , , ,#, , , , , , , , ,#, , , , , , , ,#,#, ,#, , , , , ,#,#
#,#,#,#,#,#,#,#,#,#, ,#,#, ,#,#,#, ,#,#,#,#,#,#,#,#,#,#,#,#,#,#, ,#,#, ,#,#,#,#,#,#,#,#,#,#, ,#, ,#,#,#,#,#, ,#,#,#,#, ,#,#,#, ,#,#
#,#, ,#, , , , , , , ,#,#, ,#, , , ,#, , , , , , ,#, , , ,#, , , ,#,#, , , ,#, , , , , , , , ,#, , , , , ,#, , , , , , ,#, , , ,#,#
#,#, ,#, ,#,#,#,#,#,#,#,#, ,#, ,#,#,#, ,#,#,#,#, ,#, ,#, ,#, ,#,#,#,#,#,#, ,#,#,#, ,#,#,#,#,#,#,#,#,#,#, ,#,#,#,#,#,#,#,#, ,#, ,#,#
#,#, ,#, ,#, , , ,#, ,#,#, , , ,#, , , ,#, , , , ,#, ,#, , , ,#, , , , ,#, , , ,#, ,#, , , , , , , , ,#, ,#, , , , ,#, , , ,#, ,#,#
#,#, ,#, ,#, ,#, ,#, ,#,#, ,#,#,#, ,#,#,#, ,#,#,#,#,#,#,#,#, ,#, , , , ,#,#,#, ,#,#,#, ,#,#,#,#, ,#, ,#, ,#,#,#,#, ,#, ,#,#,#, ,#,#
#,#, ,#, ,#, ,#, ,#, , , , ,#,#,#, ,#,#,#, , ,#,#,#,#,#,#,#, ,#, ,#,#, ,#,#,#, ,#,#,#, ,#,#,#,#, ,#, ,#, ,#,#,#, , ,#, ,#,#,#, ,#,#
#,#, ,#, , , ,#, ,#, , , , ,#, , , ,#, ,#, , , , , , , , ,#, ,#, ,#,#, , , ,#, , , , , ,#,#, , , ,#, ,#, , , , , , ,#, ,#, , , ,#,#
#,#, ,#,#,#,#,#, ,#,#,#,#,#,#, ,#,#,#, ,#,#,#,#,#,#,#,#, ,#, ,#,#,#,#,#,#, ,#,#,#,#,#,#,#,#, ,#,#,#,#,#,#,#, ,#,#,#,#, ,#, ,#,#,#,#
#,#, , , , , ,#, , , , , , , , ,#, , , , , , , , ,#, , , , , , , , , , , , , , , , , , ,#,#, , , , , , , , , ,#,#, , , ,#, ,#, ,#,#
#,#, ,#,#,#, ,#,#,#,#,#,#,#,#,#,#, ,#,#,#,#,#,#, ,#, ,#,#,#,#,#,#,#,#,#,#,#,#,#,#,#,#, ,#,#,#,#,#,#,#,#,#,#,#,#,#, ,#,#,#, ,#, ,#,#
#,#, ,#, , , , , , , ,#,#, ,#, , , ,#, , , ,#,#, , , ,#, , , , , ,#,#, ,#, , , , , ,#, ,#,#, , , , , , , ,#, , , , ,#, ,#, , , ,#,#
#,#, ,#,#,#,#,#,#,#, ,#,#, ,#, ,#,#,#, ,#, ,#,#,#,#,#,#,#,#, ,#, ,#,#, ,#, ,#, ,#,#,#, ,#,#,#,#,#,#, ,#,#,#, ,#,#,#,#, ,#,#,#, ,#,#
#,#, , , , , ,#, , , , , , ,#, , , ,#, ,#, ,#,#, , , , , ,#, ,#, , , , ,#, ,#, , , , , , , , , , , , ,#, , , ,#,#, ,#, , , , , ,#,#
#,#, ,#,#,#, ,#,#,#,#,#,#, ,#,#,#, ,#, ,#, ,#,#,#,#, ,#, ,#, ,#,#,#,#,#,#, ,#,#,#,#,#,#,#,#,#,#,#,#,#,#, ,#,#,#,#, ,#, ,#,#,#,#,#,#
#,#, , , ,#, , , ,#, , , , ,#, ,#, , , ,#, ,#,#, , , ,#, ,#, , , , , , , , , , , , , , ,#,#, , , , , , , ,#, ,#,#, , , ,#, , , ,#,#
#,#,#,#, ,#,#,#, ,#,#,#, , ,#, ,#,#,#,#,#, ,#,#, ,#,#,#, ,#,#,#,#,#,#,#,#, ,#,#,#,#,#, ,#,#, ,#,#,#,#,#,#,#, ,#,#, ,#,#,#, ,#, ,#,#
#,#,#,#, ,#,#,#, ,#,#,#,#, ,#, ,#,#,#,#,#, ,#,#, ,#,#,#, ,#,#,#,#,#,#,#,#, ,#,#,#,#,#, ,#,#, ,#,#,#,#,#,#,#, ,#,#, ,#,#,#, ,#, ,#,#
#,#, ,#, ,#, ,#, , , ,#,#, , , ,#, , , , , ,#,#, ,#, ,#, ,#, , , , , , ,#, ,#, , , ,#, ,#,#, , , , , , , ,#, ,#,#, , , , , ,#, ,#,#
#,#, ,#, ,#, ,#,#,#, ,#,#,#,#, ,#, ,#,#,#,#,#,#, ,#, ,#, ,#, ,#,#,#,#, ,#,#,#, ,#, ,#,#,#,#,#,#,#,#,#,#, ,#, ,#,#,#,#,#,#,#,#, ,#,#
#,#, ,#, ,#, ,#, , , ,#,#, , , ,#, , , , , , , , ,#, , , ,#, ,#, , , , , , , , ,#, , , , , , , , , , ,#, ,#, , , , , , ,#, , , ,#,#
#,#, ,#, ,#, ,#, ,#,#,#,#,#,#,#,#,#,#,#,#,#,#,#,#,#, ,#,#,#, ,#,#,#,#,#,#,#,#,#,#,#,#,#,#,#,#,#,#,#, ,#, ,#,#,#,#,#,#, ,#, ,#,#,#,#
#,#, ,#, , , ,#, , , , , , , , , , ,#, , , , , , ,#, ,#, , , , , ,#,#, , , , , , , , , ,#,#, , , , , ,#, , , ,#,#, , , ,#, , , ,#,#
#,#, ,#,#,#, ,#,#,#,#,#,#,#,#, ,#,#,#, ,#,#,#,#, ,#, ,#, ,#,#,#, ,#,#, ,#,#,#,#,#, ,#, ,#,#, ,#,#,#,#,#,#,#, ,#,#, ,#,#,#,#,#, ,#,#
#,#, , , ,#, ,#, , , , , , ,#, , , , , ,#, ,#,#, , , ,#, ,#, , , ,#,#, , , , , ,#, ,#, ,#,#, , , , , , , ,#, ,#,#, ,#, , , ,#, ,#,#
#,#, ,#, ,#, ,#,#,#, ,#,#,#,#,#,#,#,#,#,#, ,#,#,#,#,#,#,#,#, ,#,#,#,#,#,#,#,#, ,#, ,#,#,#,#,#,#,#,#,#,#, ,#, ,#,#, ,#, ,#, ,#, ,#,#
#,#, ,#, ,#, , , ,#, , , , , , , , , , ,#, , , , , , , , , , ,#, , , , , , , , ,#, , , , , , , , , , ,#, , , ,#,#, ,#, ,#, , , ,#,#
#,#, ,#, ,#,#,#, ,#, , ,#,#,#, ,#,#,#,#,#, , ,#,#,#,#,#, ,#,#,#, , ,#,#,#,#,#,#,#,#,#,#,#,#,#,#, ,#,#,#,#,#,#,#,#, ,#, ,#,#,#,#,#,#
#,#, ,#, ,#,#,#, ,#, , ,#,#,#, ,#,#,#,#,#, ,#,#,#,#,#,#, ,#,#,#, ,#,#,#,#,#,#,#,#,#,#,#,#,#,#,#, ,#,#,#,#,#,#,#, , ,#, ,#,#,#,#,#,#
#,#, ,#, , , , , ,#, , , , ,#, , , , , , , ,#,#, , , , , ,#, ,#, ,#,#, , , , , , , , , ,#,#, ,#, , , , , , , , , , , , ,#, , , ,#,#
#,#, ,#,#,#,#,#,#,#,#,#,#,#,#, ,#,#,#,#,#,#,#,#, ,#,#,#,#,#, ,#, ,#,#, ,#, ,#,#,#,#,#, ,#,#, ,#,#,#,#,#,#,#,#,#,#,#,#,#,#,#,#, ,#,#
#,#, ,#, , , ,#, , , , , , ,#, , , ,#, , , , , , ,#, ,#, , , , , ,#,#, ,#, , , ,#, , , , , , , , , , , , ,#, , , , , , , , , , ,#,#
#,#, ,#, ,#, ,#,#,#, ,#,#, ,#,#,#,#,#, ,#,#,#,#,#,#, ,#, ,#,#,#,#,#,#, ,#,#,#, ,#,#,#,#,#,#,#,#,#,#,#,#,#,#, ,#,#, ,#,#,#,#,#, ,#,#
#,#, , , ,#, ,#, , , ,#,#, , , , , , , ,#, , , , ,#, ,#, , , ,#, , , , , , ,#, ,#, , , , , , , , , , , , , , ,#,#, , , ,#, ,#, ,#,#
#,#,#,#,#,#, ,#, ,#,#,#,#,#,#,#,#,#,#,#,#, ,#,#, ,#, ,#,#,#, ,#,#,#,#,#,#,#,#, ,#, ,#,#,#,#,#,#,#,#,#,#,#,#,#,#,#,#,#, ,#, ,#, ,#,#
#,#, , , ,#, ,#, , , , , , ,#, ,#, , , , , ,#,#, , , ,#, , , ,#, , , , , , ,#, , , ,#, , , , , , , , , , ,#, ,#,#, , , ,#, , , ,#,#
#,#, ,#,#,#, ,#, ,#,#,#,#, ,#, ,#, ,#,#,#, ,#,#,#,#,#,#, ,#,#,#, ,#,#,#,#, ,#,#,#, ,#, ,#,#,#,#,#,#,#,#, ,#, ,#,#, ,#,#,#, ,#,#,#,#
#,#, ,#, , , ,#, ,#, , , , ,#, ,#, ,#, ,#, , , , , , ,#, ,#, , , ,#,#, ,#, , , ,#, ,#, , , , ,#, , , , , ,#, ,#,#, ,#, , , ,#, ,#,#
#,#, ,#, ,#,#,#, ,#, ,#,#,#,#, ,#, ,#, ,#,#,#,#,#,#, ,#, ,#,#,#, ,#,#, ,#,#,#, ,#, ,#,#,#, , ,#,#,#,#,#, ,#, ,#,#, ,#, ,#,#,#, ,#,#
#,#, ,#, ,#,#,#, ,#, ,#,#,#,#, ,#, ,#, ,#,#,#,#,#,#, ,#, ,#,#,#, ,#,#, ,#,#,#, ,#, ,#,#,#,#, ,#,#,#,#,#, ,#, ,#,#, ,#, ,#,#,#, ,#,#
#,#, ,#, , , ,#, ,#, ,#,#, , , , , , , ,#, , , , , , ,#, , , , , ,#,#, , , , , ,#, , , ,#,#, , , , , ,#, ,#, ,#,#, ,#, , , , , ,#,#
#,#, ,#,#,#, ,#,#,#, ,#,#,#,#,#,#,#,#,#,#, ,#,#,#,#,#,#,#,#,#,#,#,#,#, ,#,#,#,#,#,#,#, ,#,#,#,#,#,#, ,#, ,#, ,#,#, ,#,#,#,#,#, ,#,#
#,#, , , ,#, ,#, , , ,#,#, , , , , , , ,#, ,#,#, , , , , , , ,#, ,#,#, , , , , , , ,#, , , , , , ,#, ,#, ,#, ,#,#, , , , , ,#, ,#,#
#,#, ,#, ,#, ,#, ,#,#,#,#, ,#,#,#,#,#, ,#, ,#,#, ,#, ,#,#,#, ,#, ,#,#,#,#,#,#,#,#, ,#,#,#,#,#,#, ,#, ,#, ,#, ,#,#,#,#,#,#, ,#, ,#,#
#,#, ,#, ,#, , , ,#, , , , , , ,#, ,#, , , ,#,#, ,#, ,#, ,#, , , , , , , , ,#, , , ,#, , , , ,#, , , ,#, , , , , , ,#, , , ,#, ,#,#
#,#,#,#, ,#,#,#, ,#, ,#,#,#,#, ,#, ,#,#,#, ,#,#, ,#, ,#, ,#, ,#,#,#,#,#,#, ,#, ,#,#,#,#,#,#, ,#,#,#, ,#,#,#,#,#,#, ,#, ,#,#,#,#,#,#
#,#, , , , , ,#, , , ,#,#, , , ,#, ,#, , , ,#,#, ,#, ,#, , , ,#, , , , ,#, ,#, ,#, , , , , , ,#, , , ,#, , , ,#,#, ,#, ,#, , , ,#,#
#,#, ,#,#,#, ,#, ,#,#,#,#, ,#,#,#, ,#, ,#,#,#,#, ,#, ,#, ,#,#,#, ,#,#, ,#, ,#, ,#, ,#,#,#,#,#,#, ,#,#,#, ,#, ,#,#, ,#, ,#, ,#, ,#,#
#,#, ,#, , , ,#, ,#, ,#,#, ,#, , , , , ,#, , , , ,#, ,#, , , ,#, ,#,#, ,#, ,#, ,#, , , , , , , , ,#, , , ,#, ,#,#, ,#, , , ,#, ,#,#
#,#, ,#, ,#,#,#, ,#, ,#,#, ,#, ,#,#,#,#,#, , ,#,#,#, ,#,#,#,#,#, ,#,#, ,#,#,#, ,#, ,#,#,#,#,#,#,#,#, ,#,#,#, ,#,#,#,#,#,#, ,#, ,#,#
#,#, ,#, ,#,#,#, ,#, ,#,#, ,#, ,#,#,#,#,#, , ,#,#,#, ,#,#,#,#,#, ,#,#, ,#,#,#, ,#, ,#,#,#,#,#,#,#,#, ,#,#,#, , ,#,#,#,#,#, ,#, ,#,#
#,#, ,#, ,#, ,#, ,#, ,#,#, ,#, , , , , ,#, , , , ,#, , , , , , , ,#,#, , , , , ,#, , , , , , , , ,#, , , ,#, , , , , , ,#, ,#, ,#,#
#,#, ,#, ,#, ,#, ,#, ,#,#, ,#,#,#,#,#, ,#,#,#,#, ,#,#,#,#,#,#,#,#,#,#,#,#,#,#,#,#,#,#,#,#,#,#,#,#,#,#,#, ,#,#,#,#,#,#, ,#,#,#, ,#,#
#,#, ,#, , , ,#, ,#, ,#,#, , , , , ,#, , , ,#,#, , , ,#, , , , , , , , , , , , , , , , , , , , , ,#, , , ,#, , , , ,#, , , ,#, ,#,#
#,#, ,#,#,#,#,#, ,#, ,#,#,#,#,#,#, ,#, ,#,#,#,#,#,#, ,#, ,#,#,#,#,#,#,#,#,#,#,#,#,#,#,#,#,#,#,#, ,#, ,#,#,#, ,#,#,#,#,#,#, ,#, ,#,#
#,#, , , , , , , ,#, , , , ,#, , , ,#, ,#, , , , ,#, , , ,#, , , ,#,#, , , ,#, , , , , ,#,#, , , ,#, ,#, , , ,#,#, , , ,#, ,#, ,#,#
#,#, ,#,#,#,#,#,#,#, ,#,#, ,#, ,#,#,#,#,#, ,#,#, ,#,#,#,#,#, ,#,#,#,#, ,#, ,#, ,#, ,#,#,#,#, ,#,#,#, ,#, ,#,#,#,#, ,#, ,#, ,#, ,#,#
#,#, , , , , , , , , ,#,#, ,#, , , , , , , ,#,#, , , , , , , , , , , , ,#, , , ,#, , , , , , , , , , ,#, , , , , , ,#, , , , , ,#,#
#,#,#,#,#,#,#,#,#,#,#,#,#,#,#,#,#,#,#,#,#,#,#,#,#,#,#,#,#,#,#,#,#,#,#,#,#,#,#,#,#,#,#,#,#,#,#,#,#,#,#,#,#,#,#,#,#,#,#,#,#,#,#,#,#,#
#,#,#,#,#,#,#,#,#,#,#,#,#,#,#,#,#,#,#,#,#,#,#,#,#,#,#,#,#,#,#,#,#,#,#,#,#,#,#,#,#,#,#,#,#,#,#,#,#,#,#,#,#,#,#,#,#,#,#,#,#,#,#,#,#,#
